WORLD
32 32
 01234567890123456789012345678901
0#..............................#
1.....................#####......
2....#.#.#.#..#.#.#..............
3....#######...#.#....#.#.#......
4....#######..#.#.#..............
5....#######...#.#...###.###.....
6................................
7......#.#.............#.#.......
8......#.#.............#.#.......
9......#.#.............#.#.......
0......#.#####.........#.#.......
1......#.....#.........#.#.......
2......#.###.#.........#.#.......
3......#.#.#.###########.#######.
4......#.#.#...................#.
5......#.#.#####################.
6......#.#.......................
7......#.#...########............
8......#.#...#......#............
9......#.#...########............
0......#.#................####...
1......#.#.........#####..#..#...
2......#.###########...####..#...
3......#.....................#...
4..#####.###########...####..#...
5..#.....#.........#####..#..#...
6..#.#####.....#..........####...
7..#.#.........#.................
8..#.#......#######..............
9..#.#.........#.................
0..............#.................
1#..............................#