WORLD
8 8
 01234567
0#......#
1...###..
2...#....
3..##....
4...#....
5...#....
6........
7#......#
